00000000000000000000000000000000
00000000000000000000000000000000
00000000000000000000000000000000
00000000000000000000000000000000
00000000000000000000000000000000
00000000000000000000000000000000
00000000444444444400000000000000
00000000444444444400000000000000
00000000444444444400000000000000
00000000000000000000000003000000
00000000000000000000000000000000
00000000000000000000000000000000
00000000000000000000000000000000
00000002222222220000000000000000
00000000000000000000000000000000
00000000000000000000000000000000
00000000000000000000000000000000
00000000000000000000000000000000