00000000000000000000000000000000
00001111110000000000000000000000
00000000000000000000000000000000
00000000000000444400000000000000
00000000000000444400000000000000
00000000000000444400000000000000
00000000000000444400000000010000
00000000000000444400002220010000
00000000000000444400002000010000
00000000000000444400002030010000
00000000000000444400002000010000
00000000000000444400002220010000
00000000000000444400000000010000
00000000000000444400000000000000
00000000000000444400000000000000
00000000000000000000000000000000
00001111110000000000000000000000
00000000000000000000000000000000