00000000000000000000000000222200
00000000000000000000000000000000
20000000000000000000000000000
20000000000000000000000000000000
20000000000000000000000000000000
20000000000444022204440000000000
00000000000444000004440000000000
00000000000444000004440000000000
00000000000000000000000000000000
00000000000020003000020000000000
00000000000000000000000000000000
00000000000444000004440000000000
00000000000444000004440000000002
00000000000444022204440000000002
00000000000000000000000000000002
00000000000000000000000000000002
00000000000000000000000000000000
00222200000000000000000000000000