0000010001000100010001000100000
00000000000000000000000000000000
00010001000100010001000100014000
00000000000000000000000000004000
00000000000000000000000000044000
00000000000111111111100000044000
00000000000111111111100000044000
00000000000110000001100000044000
00000000000110000001100000044000
00000000000110000001100000044030
00000000000110000001100000044000
00000000000111111111100000044000
00000000000111111111100000044000
00000000000000000000000000044000
00000000000000000000000000044000
00000200020002000200020002004000
00000000000000000000000000000000
00020002000200020002000200020000