00000000000000000000000000000000
00000000444444444444444000000000
00000000444444444444444000000000
00000000000000000000000000000000
00000000000111110000000000000000
04400000000000000000000000000440
04400011111000000000000000000440
04400000000000000000000000000440
04400000000000000000000000000440
04400000000000030000000000000440
04400000000002222200000000000440
04400000000000000000000000000440
00000000000000000000000000100000
00000000000000000000000000100000
00000000000000000000000011100000
00000000444444444444444000000000
00000000444444444444444000000000
00000000000000000000000000000000