00000000000000000000000000000000
00000000000000000000000000000000
00000000000000000000000000000000
00000000000000000000000000000000
00000004444444444444444444000000
00000000000000000000000000000000
00000000000000000000000000000000
00000000000000044444444440000000
00000000004444444444444440000000
00000000000000000000000000000000
00000000000000000000000000030000
00000000000000000000000000000000
00000000000000000000000000000000
00000000000000000000000000000000
04444444444444444400000000000000
00222222222222222222000000000000
00000000000000000000000000000000
00000000000000000000000000000000