10000000000000000000000000000001
00000000000000000000000000000000
00000000010000000000000000000000
00000000000000000000000000000000
00000000000000001110000000000000
00000000000000000000000030000000
00000000011000000000000000000000
00000000111110000000000000000000
00000000000000000000000000000000
00011000000000000000111110000000
00000000000000000000000000000000
00000000000000000000000000000000
00000000000000111111100000000000
00000001111111111000000000000000
00000000000000000000000000000000
00000000111000001000000000000000
00000000000000000000000000110000
10000001111111000000000000000001