00000000000000000000000000000000
00000000000000000000000000000000
00000000000000100000000000000000
00011111000000100000000000000000
00000000000000100000000000000000
00000000000000111111100000000000
00000000000000000000000000000000
00000000000010000000000022220000
00000000000010000000000000020000
00000000000010000000000003020000
00000000000010000000000000020000
00000000000010000000000022220000
00000000000000000000000000000000
00000000000000111111100000000000
00000000000000100000000000000000
00011111000000100000000000000000
00000000000000100000000000000000
00000000000000000000000000000000