00000000000000010000000000000000
00000000000000010000000000000000
00000001000000010000000100000000
00000001000000010000000100000000
00000001000000010000000100000000
00000001000000000000000100000000
00000001000000010000000100000000
00000000000000010000000000000000
00000000000000010000000000300000
00000000000000010000000000000000
00000000000000010000000000000000
00000001000000000000000100000000
00000001000000010000000100000000
00000001000000010000000100000000
00000001000000010000000100000000
00000001000000010000000100000000
00000000000000010000000000000000
00000000000000010000000000000000