11110000000000000000000000200000
10000000000000000000000000200300
10000000000000000000000000200000
00000000000000000000000000000222
00000000000004444000000011110000
00000444444444444444444444000000
00000444444444444444444444000000
00004444444444444444444444400000
00004444444444444444444444400000
00004444444444444444444444400000
00004444444444444444444444400000
00000444444444444444444444000000
00000444444444444444444444000000
00000000000004444000000000000000
00000000000000000000000000000001
00000000000000000000000000000001
00000000002222222222200000000001
00000000000000000000000000000111