22222200000000000000000000222222
22222200000400000004000000222222
22000000000400030004000000000022
22000000000400000004000000000022
00000000000444000444000000000000
00000010000000000000000000000000
00000010000000000000011111000000
00000010000002222200000000000000
00000010000000000000000000000000
00000000000000000000000000000000
00000111110000000000000000100000
00000000000000000000000000100000
00000000000000000000000000100000
00000000000000000000000000100000
00000111111110000000000000100000
00000000000000000000111000000000
00000000000000000000000000000000
00000000001111110000000000000000